# . . . . . # . . . . . . . . . . . # . . . . . # . . . # . . . . . . . . . . . #
# # # . # . # # # # # # # . # # # . # . # # # . # . # . # # # # # # # # # # # . #
# . . . # . # . . . . . # . # . . . # . # . . . # . # . . . . . . . . . # . . . #
# . # # # . # . # # # . # . # # # . # . # . # # # . # # # # # # # # # . # . # . #
# . # . # . # . # . . . # . . . # . . . # . # . . . . . # . . . . . . . # . # . #
# . # . # . # . # . # # # # # . # # # # # . # . # # # # # . # # # # # # # . # . #
# . # . . . . . # . # . . . . . # . . . . . # . # . . . . . # . . . . . . . # . #
# . # # # # # # # . # . # # # # # . # # # # # . # . # # # # # . # # # # # # # . #
# . . . . . . . # . . . # . . . # . . . # . . . # . . . # . . . # . . . . . . . #
# . # # # # # . # # # # # . # . # # # . # . # # # # # . # # # . # . # # # # # # #
# . . . . . # . # . # . . . # . . . # . # . # . . . . . # . . . # . # . . . . . #
# # # # # # # . # . # . # . # # # # # . # . # . # # # # # . # # # . # . # # # . #
# . . . # . . . # . # . # . . . . . . . # . # . . . . . # . # . # . # . # . . . #
# . # . # . # # # . # . # # # # # # # # # . # # # # # . # . # . # . # . # . # # #
# . # . . . # . . . # . # . . . # . . . # . . . # . . . # . # . . . # . # . . . #
# . # # # # # # # . # . # . # . # . # # # # # . # . # # # . # . # # # # # # # . #
# . . . # . . . # . . . # . # . . . # . . . . . # . # . . . # . # . . . . . # . #
# . # . # . # . # . # # # . # . # # # . # # # # # . # # # . # . # . # # # . # . #
# . # . . . # . # . # . . . # . # . . . . . . . # . # . . . # . . . # . # . # . #
# # # # # # # . # . # . # # # . # . # # # # # . # . # . # # # # # # # . # . # . #
# . . . . . . . # . # . . . # . # . . . # . # . # . # . # . . . # . . . # . # . #
# . # # # # # # # . # # # . # # # # # . # . # # # . # . # # # . # . # . # . # . #
# . . . # . . . # . . . # . # . . . . . # . # . . . # . . . # . . . # . # . # . #
# . # . # # # . # # # . # . # . # # # # # . # . # # # # # . # . # # # . # . # . #
# . # . # . . . . . # . . . # . . . . . # . # . # . . . . . # . # . # . . . # . #
# . # . # . # . # # # # # . # # # # # . # . # . # # # . # # # . # . # # # # # . #
# . # . # . # . # . . . . . # . . . . . # . . . # . . . # . # . . . # . . . # . #
# . # . # . # # # . # # # # # . # # # # # # # # # . # # # . # # # . # . # . # . #
# . # . # . . . # . . . # . . . # . . . . . # . . . . . # . . . . . # . # . # . #
# # # . # # # . # . # # # . # # # # # . # . # # # . # . # . # # # # # . # . # . #
# . . . # . . . # . # . . . # . . . . . # . . . # . # . # . # . . . . . # . # . #
# . # # # . # # # . # . # # # # # . # # # # # . # # # . # . # . # # # . # . # . #
# . # O . . . . . . # . . . . . # . # . . . # . . . . . # . # . . . # . # . . . #
# . # # # # # # # # # # # # # . # . # . # . # # # # # # # . # # # . # . # # # . #
# . # . . . . . . . # . . . # . # . . . # . # . # . . . # . # . . . # . . . # . #
# . # . # # # # # . # . # . # . # . # # # . # . # . # . # . # # # # # . # . # . #
# . # . # . . . # . # . # . # . # . # . . . # . . . # . . . # . . . # . # . # . #
# . # . # # # . # . # . # . # . # # # . # # # . # # # # # # # . # . # # # . # . #
# . . . . . . . # . . . # . . . . . . . # . . . . . . . . . . . # . . . . . # . #
# # # # # # # # # # # # # # # # # # # # # # # # # # # # # # # # # # # # # # # # #